1,1,1,1,1
1,0,1,1,1
1,0,0,0,1
1,0,0,0,1
1,1,1,1,1
,,,,
,,,0:空気,
,,,1:ブロック,
,,,2:プレイヤー,